Add Share=Aggiungi Condivisione
All files encrypted=Tutti i file criptati
All files protected=Tutti i file protetti
All files unprotected=Tutti i file non protetti
Allocation method=Metodo di allocazione
Array must be Started to view Shares=L'array deve essere avviato per visualizzare le Condivisioni
Automatically split any directory as required=Dividi automaticamente ogni cartella dove richiesto
Automatically split only the top five directory levels as required=Dividi automaticamente solo i primi cinque livelli di cartelle
Automatically split only the top four directory levels as required=Dividi automaticamente solo i primi quattro livelli di cartelle
Automatically split only the top level directory as required=Dividi automaticamente solo il primo livello di cartelle
Automatically split only the top three directory levels as required=Dividi automaticamente solo i primi tre livelli di cartelle
Automatically split only the top two directory levels as required=Dividi automaticamente solo i primi due livelli di cartelle
Clean Up=Pulisci
CLEAN UP=PULISCI
Comments=Commenti
Compute All=Calcola tutto
Compute=Calcola
Disk Shares=Dischi Condivisi
Do not use pool names=Non usare nomi di pool
Do not use reserved names=Non usare nomi riservati
Enable Copy-on-write=Abilita il Copy-on-write
Enter a name for the share=Inserisci un nome per la Condivisione
Excluded disks=Dischi esclusi
Exclusive access=Accesso Esclusivo
Export=Esporta
Fill-up=Riempi
Free=Liberi
has been deleted=è stato cancellato
HDD=HDD
High-water=High-water
Included disks=Dischi inclusi
Invalid Characters=Caratteri non validi
Invalid share name=Nome Condivisione non valido
is missing=è mancante
Manual do not automatically split directories=Manuale: non dividere automaticamente le directory
Missing share name=Nome Condivisione mancante
Most-free=Il più libero
Mover takes no action=Lo spostamento non comporta alcuna azione
Mover transfers files from array to cache=Lo spostamento trasferisce i file dall'array alla cache
Mover transfers files from cache to array=Lo spostamento trasferisce i file dalla cache all'array
next user share=condivisione prossimo utente
Not used=Non in uso
Only=Solo
Prefer=Preferisci
previous user share=condivisione utente precedente
Primary storage %s=Archiviazione Primaria %s
Primary storage for new files and folders=Archiviazione Primaria (per nuove cartelle e file)
Primary storage to Secondary storage=Da Archiviazione Primaria ad Archiviazione Secondaria
Read=Leggi
Recompute=Ricalcola
Removed share configurations=Rimuovi configurazioni Condivisione
Rule=Regola
Secondary storage to Primary storage=Da Archiviazione Secondaria ad Archiviazione Primaria
Secondary storage=Archivizione Secondaria
Select cache pool=Seleziona il pool per la cache
Set when adding new share only=Imposta solo quando aggiungi una nuova Condivisione
Share contains data=La Condivisione contiene dati
Share is empty and is safe to delete=La condivisione è vuota e può essere eliminata
Share is empty=La Condivisione è vuota
Share is outside the list of designated disks=La Condivisione è fuori dalla lista dei dischi selezionati
Share must be empty to be deleted=La condivisione deve essere vuota per poter essere eliminata
Share Settings=Impostazioni Condivisione
Share status=Stato Condivisione
Size=Dimensione
Some or all files unencrypted=Alcuni o tutti i file non criptati
Some or all files unprotected=Alcuni o tutti i file non protetti
Split level=Livello di divisione
SSD=SSD
Storage=Archiviazione
There are no exportable disk shares=Non ci sono condivisioni disco esportabili
There are no exportable user shares=Non si sono condivisioni utente esportabili
This share is invalid=Condivisione non valida
Time Machine volume size limit=Limite dimensione volume Time Machine
Unknown cache usage=Utilizzo cache sconosciuto
Unknown encryption state=Stato crittografia sconosciuto
Unknown protection status=Stato protezione sconosciuto
Use cache pool for new filesdirectories=Usa la pool di cache per nuovi file e directory
User Shares=Cartelle Condivise
Write=Scrivi
You cannot use the following within share names=Non puoi usare i seguenti nei nomi della condivisione

; Note: April 21, 2025 - 13 missing translations
Free Space will be calculated=
it references storage that does not exist=
It references storage that does not exist=
Minimum free space=
Mover action=
Mover transfers files from Primary storage to Secondary storage=
Mover transfers files from Secondary storage to Primary storage=
No unused share configurations present=
Remove unused share configurations=
Share name contains invalid characters for ZFS use=
There are no mountable array or pool disks - cannot add shares=
There are no mounted array or pool disks - cannot add shares=
Warning: Configured Pool=
